1,1,1,1,0,0,1,1,1,1
1,0,0,0,0,0,0,7,0,1
1,0,0,0,0,0,0,0,0,1
0,0,0,4,2,0,5,0,0,0
0,0,0,0,0,0,0,0,0,0
1,0,0,0,0,0,0,0,0,1
1,0,0,0,0,0,0,0,0,1
1,1,1,1,6,1,1,1,1,1